11111111111111
10000010000001
100P0010000001
100CC000000001
1E000000000001
11111111111111